1111111111111111111111111
1C01000T00001T0110000P011
1000C11111001000000100111
1000010000000001001110011
111100C1E0001111000000001
110010111110000100110C001
10T00000C0001100011111101
1011110011101111000000101
1C00000001E00000C110T0001
1111111111111111111111111