1111111111111111
1C01000000001111
1000E11111001111
1P0011000T001111
1111111111111111
1111111111111111