111111111111
1C01000T01P1
1000C1111101
100001000001
111100C1E0C1
111111111111